 ####
# #  #
# $  #
#  # #
#    #
# .@ #
 ####
;test_1
 
#######
#     #
#     #
#. #  #
#. $$ #
#.$$  #
#.#  @#
#######
;test_2 

#######
#     #
# $   #
#.@#$ #
#.    #
#*    #
#*#   #
#######
;test_3
 
       #### ###################
  #####  ###            .$   #
###  $.       #####$####   # #
#    $.  #### #     .   ### .#
#  $ $.### ## # #### #  $.# $#
###  $.## # # # #  #  # $ #  #
  ###### # ## #$ $ ##   #. # #
        ##### #.#.  #  ### # #
 #####  #   # ### ###   #    #
 ##*##  #     .#  #   #$$*  ##
 #*### ### ## ## ## #  .#. ##
 ###*# #  .$ .# $.$.## ### #
 ##*## # #.####     # $.   ##
 #*### # $$   ### ###   ##  ##
 ###*# # #   . $@$  #######. #
 ##### # ### ####.#        $ #
       #     #  ###########  #
       #######            ####
 ;test_4
 
                   #####
            ##### #   #
            #   ### # #
      ##### # #       #
##### #   # #   #### ##
#   ### # # ### #  # #
# #    @  #   # #  # ###
#   ####$###### ####   #
### #  # .      #    # #
  # #  #  ##  #    #   #
 ## #####  ##    # #####
 #         ##  ### #
 # # ### #  #####  # #####
 #   # #    # #    # #   #
 ##### #  #####  # ### # #
       # ###  ##         #
   ##### #    ##  ##### ##
   #   #    #  ##  #  # #
   # #    #        #  # ###
   #   #### ###### ####   #
   ### #  # #   #       # #
     # #  # ### # # ###   #
    ## ####   # #   # #####
    #       # # #####
    # # ###   #
    #   # #####
    #####
 ;test_5
 
                       ####   ##### ####
    #####  ########   #  #   #   ###  #
    #   ####  #   #####  #   #        #
#####         #          ######## ##  #
#   #####     ## ###### ##  #   #  # ####
#         #####  #   #      #      # #  #
## ###### ##  #      #   #  ## ##  # #  #
 # #   #      #  ## ###### ###  #### #  #
##     #   #  ####  #   #       #  # # ##
#  ## ###### ##  #      #   ##  #      #
#  #  #   #      #  ## ##########  ##  #
#  #      #   #  ##### ##    #  ## ##  ##
####  ## ###### ##  ## #     #      #   #
   ##### ##  #         #  ####  #   #   #
   #   #  #  #   ##  # ## #  ## #########
   #      #  #########  # #      #   #  #
##### ##  #             # #  #   #      #
#   #  #####  ####  #  ## ## ###### ##  #
#      #  #####  ## ####  ##  #   #  # ##
### #  #          #  #    #   #      # #
  # ####  ### ##  #### ## #  ### ##  # #
  # #  ## ###  # ## ####  ## ###  #### #
  # #      #   #    #  #          #  # ###
 ## #  #   #  ##  #### ##  #####  #      #
 #  ## ###### ## ##  #  ####  #####  #   #
 #      #   #  # #             #  ## #####
 #  #   #      # #  #########  #      #
 ######### ##  # ## #  ##   #  #  #   #
 #   #   #  ####  #         #  ## #####
 #   #      #     # ##  ## ###### ##  ####
 ##  ## ##  #    ## #####  #   #      #  #
  #  ##  ########## ##  #      #   #  #  #
  #      #  ##   #      #  ## ###### ##  #
 ## # #  #       #   #  ####  #   #     ##
 #  # ####  ### ###### ##  #      #   # #
 #  # #  ## ##  #   #      #  ## ###### ##
 #  # #      #      #   #  #####$.@      #
 #### #  #   #  ## ###### ##     #####   #
   #  ## ########          #         #####
   #        #   #  #####   #  ####   #
   #  ###   #   #  #   ########  #####
   #### #####   ####
 ;test_6
 
  ############################
 #                          #
 # ######################## #
 # #                      # #
 # # #################### # #
 # # #                  # # #
 # # # ################ # # #
 # # # #              # # # #
 # # # # ############ # # # #
 # # # # #            # # # #
 # # # # # ############ # # #
 # # # # #              # # #
 # # # # ################ # #
 # # # #                  # #
##$# # #################### #
#. @ #                      #
#############################
 ;test_7
 
   ####
###  #
# $.@##
#  *  #
#  *  #
#######
; test_8

######
#@$*.#
######
;unsolvable

##### #####
#   ###   #
#    #    #
### @ $ ###
  ##   *#
   ##   #
    ##.##
     ###
;azaza

#########
#     . #
#   $   #
#  # @$ #
#    .  #
#########
;eeee

#########
#   @   #
# $.$.$.#
#       #
# .$.$.$#
#       #
#########
;2105

#######
#@.$  #
#  #  #
#######
;testAstar

###
#@#
###
;test1x1

#######
#     #
# .$  #
##.$###
#  @  #
# .$# #
#     #
#######
;g14

#########
#  .#   #
#.    $ #
#   # $@#
#####   #
    #####
;2boxes